{
    "希腊": {
        "A": "Α",
        "a": "α",
        "B": "Β",
        "b": "β",
        "G": "Γ",
        "g": "γ",
        "D": "Δ",
        "d": "δ",
        "E": "Ε",
        "e": "ε",
        "Z": "Ζ",
        "z": "ζ",
        "H": "Η",
        "h": "η",
        "Q": "Θ",
        "q": "θ",
        "I": "Ι",
        "i": "ι",
        "K": "Κ",
        "k": "κ",
        "L": "Λ",
        "l": "λ",
        "M": "Μ",
        "m": "μ",
        "N": "Ν",
        "n": "ν",
        "X": "Ξ",
        "x": "ξ",
        "O": "Ο",
        "o": "ο",
        "P": "Π",
        "p": "π",
        "R": "Ρ",
        "r": "ρ",
        "S": "Σ",
        "s": "σ",
        "T": "Τ",
        "t": "τ",
        "U": "Υ",
        "u": "υ",
        "F": "Φ",
        "f": "φ",
        "C": "Χ",
        "c": "χ",
        "Y": "Ψ",
        "y": "ψ",
        "W": "Ω",
        "w": "ω"
    },
    "科普特": {
        "a": "Ϭ"
    }
}